1 1 0 2 2 0 1 1 0 2 2 0 1 1 0
1 1 0 2 2 0 1 1 0 2 2 0 1 1 0
1 1 0 2 2 0 1 1 0 2 2 0 1 1 0
0 0 0 0 0 0 0 0 0 0 0 0 0 0 0
0 1 1 0 2 2 0 1 1 0 2 2 0 1 1
0 1 1 0 2 2 0 1 1 0 2 2 0 1 1
0 1 1 0 2 2 0 1 1 0 2 2 0 1 1
0 0 0 0 0 0 0 0 0 0 0 0 0 0 0
1 1 0 2 2 0 1 1 0 2 2 0 1 1 0
1 1 0 2 2 0 1 1 0 2 2 0 1 1 0
1 1 0 2 2 0 1 1 0 2 2 0 1 1 0
0 0 0 0 0 0 0 0 0 0 0 0 0 0 0
0 1 1 0 2 2 0 1 1 0 2 2 0 1 1
0 1 1 0 2 2 0 1 1 0 2 2 0 1 1
0 1 1 0 2 2 0 1 1 0 2 2 0 1 1
0 2
14 12
0 14
14 0
0.0