0 0 0 0 0 0 0 0 0 0 0 0 0 0 0
0 1 1 1 1 1 1 1 1 1 1 1 1 1 0
0 1 0 0 0 0 0 0 0 0 0 0 0 1 0
0 1 0 1 1 1 1 2 1 1 1 1 0 1 0
0 1 0 1 0 0 0 0 0 0 0 1 0 1 0
0 1 0 1 0 1 1 1 1 1 0 1 0 1 0
0 1 0 1 0 1 0 0 0 1 0 1 0 1 0
0 2 0 1 1 2 0 2 0 1 0 2 0 1 0
0 1 0 1 0 1 0 0 0 1 0 1 0 1 0
0 1 0 1 0 1 1 2 1 1 0 1 0 1 0
0 1 0 1 0 0 0 0 0 0 0 1 0 1 0
0 1 0 1 1 1 1 1 1 1 1 1 0 1 0
0 1 0 0 0 0 0 0 0 0 0 0 0 1 0
0 1 1 1 1 1 1 2 1 1 1 1 1 1 0
0 0 0 0 0 0 0 0 0 0 0 0 0 0 0
0 0
14 14
2 2
12 12
0.45